###############3################################################
#                                                              #
#                                                              #
W                                                              #
#                                                              #
#              c                                              m2
################################################################
