################################################################
#                            m                                 #
#                                                              #
#                                                              #
#                                                              #
W              c                                               N
################################################################
