###############3################################################
#                                                      m       #
#                                                              #
1                                                              #
#                                                              #
#              c                                               2
################################################################
