#####1###########
#              c#
2               #
#c              #
#               #
#c c            3
#################
