#######################
3                     #
#            cccccc   #
#          cc  c c c  #
# cc     cc    ccccc  #
#c  cc cc          c  #
# cc  cc    c      c  #
#   cc  c   c      c  #
#   cc      c    cc   #
#   cccccc  cc cc     #
#        cccccc       #
#        cc cc        #
#######################
